Assets/Resources/Charactors/Adventurer Male 01.prefab	assets/resources/charactors/adventurermale01.prefab.dat
Assets/Resources/MapDatas/level1.json	assets/resources/mapdatas/level1.json.dat
Assets/Resources/MapRes/1/Box_A1.prefab	assets/resources/mapres/1/box_a1.prefab.dat
Assets/Z ! Voxel BlocksAssets/Prefabs/Textures/BoxA.psd	assets/z!voxelblocksassets/prefabs/textures/boxa.psd.dat
Assets/Standard Assets/Effects/ToonShading/Shaders/ToonLit.shader	assets/shader/package.shader.dat
Assets/Z ! Voxel BlocksAssets/Prefabs/Materials/BoxA.mat	assets/z!voxelblocksassets/prefabs/materials/boxa.mat.dat
Assets/Standard Assets/Effects/ToonShading/Textures/ToonLit.psd	assets/standardassets/effects/toonshading/textures/toonlit.psd.dat
Assets/Resources/MapRes/1/Box_A2.prefab	assets/resources/mapres/1/box_a2.prefab.dat
Assets/Resources/MapRes/1/Box_A3.prefab	assets/resources/mapres/1/box_a3.prefab.dat
Assets/Resources/MapRes/1/Box_A4.prefab	assets/resources/mapres/1/box_a4.prefab.dat
Assets/Resources/MapRes/1/Box_B2.prefab	assets/resources/mapres/1/box_b2.prefab.dat
Assets/Z ! Voxel BlocksAssets/Prefabs/Textures/BoxB.psd	assets/z!voxelblocksassets/prefabs/textures/boxb.psd.dat
Assets/Z ! Voxel BlocksAssets/Prefabs/Materials/BoxB.mat	assets/z!voxelblocksassets/prefabs/materials/boxb.mat.dat
Assets/Resources/MapRes/1/Box_B3.prefab	assets/resources/mapres/1/box_b3.prefab.dat
Assets/Resources/MapRes/1/Box_C1.prefab	assets/resources/mapres/1/box_c1.prefab.dat
Assets/Z ! Voxel BlocksAssets/Prefabs/Textures/BoxC.psd	assets/z!voxelblocksassets/prefabs/textures/boxc.psd.dat
Assets/Z ! Voxel BlocksAssets/Prefabs/Materials/BoxC.mat	assets/z!voxelblocksassets/prefabs/materials/boxc.mat.dat
Assets/Resources/MapRes/1/Box_C2.prefab	assets/resources/mapres/1/box_c2.prefab.dat
Assets/Resources/MapRes/1/Box_C3.prefab	assets/resources/mapres/1/box_c3.prefab.dat
Assets/Resources/MapRes/1/Box_C4.prefab	assets/resources/mapres/1/box_c4.prefab.dat
Assets/Resources/MapRes/10/Box_E1.prefab	assets/resources/mapres/10/box_e1.prefab.dat
Assets/Z ! Voxel BlocksAssets/Prefabs/Textures/BoxE_Alpha.tga	assets/z!voxelblocksassets/prefabs/textures/boxe_alpha.tga.dat
Assets/Z ! Voxel BlocksAssets/Prefabs/Textures/BoxE.psd	assets/z!voxelblocksassets/prefabs/textures/boxe.psd.dat
Assets/Z ! Voxel BlocksAssets/Prefabs/Textures/BoxE_n.tga	assets/z!voxelblocksassets/prefabs/textures/boxe_n.tga.dat
Assets/Z ! Voxel BlocksAssets/Prefabs/Materials/BoxE.mat	assets/z!voxelblocksassets/prefabs/materials/boxe.mat.dat
Assets/Resources/MapRes/10/Box_E2.prefab	assets/resources/mapres/10/box_e2.prefab.dat
Assets/Resources/MapRes/10/Box_E3.prefab	assets/resources/mapres/10/box_e3.prefab.dat
Assets/Resources/MapRes/10/Box_E4.prefab	assets/resources/mapres/10/box_e4.prefab.dat
Assets/Resources/MapRes/10/Box_E5.prefab	assets/resources/mapres/10/box_e5.prefab.dat
Assets/Resources/MapRes/10/Box_E6.prefab	assets/resources/mapres/10/box_e6.prefab.dat
Assets/Resources/MapRes/10/Box_E7.prefab	assets/resources/mapres/10/box_e7.prefab.dat
Assets/Resources/MapRes/10/Box_E8.prefab	assets/resources/mapres/10/box_e8.prefab.dat
Assets/Resources/MapRes/2/Box_A5.prefab	assets/resources/mapres/2/box_a5.prefab.dat
Assets/Resources/MapRes/2/Box_A6.prefab	assets/resources/mapres/2/box_a6.prefab.dat
Assets/Resources/MapRes/2/Box_A7.prefab	assets/resources/mapres/2/box_a7.prefab.dat
Assets/Resources/MapRes/2/Box_A8.prefab	assets/resources/mapres/2/box_a8.prefab.dat
Assets/Resources/MapRes/2/Box_B4.prefab	assets/resources/mapres/2/box_b4.prefab.dat
Assets/Resources/MapRes/3/Box_B1.prefab	assets/resources/mapres/3/box_b1.prefab.dat
Assets/Resources/MapRes/3/Box_B5.prefab	assets/resources/mapres/3/box_b5.prefab.dat
Assets/Resources/MapRes/3/Box_B6.prefab	assets/resources/mapres/3/box_b6.prefab.dat
Assets/Resources/MapRes/3/Box_B7.prefab	assets/resources/mapres/3/box_b7.prefab.dat
Assets/Resources/MapRes/3/Box_B8.prefab	assets/resources/mapres/3/box_b8.prefab.dat
Assets/Resources/MapRes/4/Box_C5.prefab	assets/resources/mapres/4/box_c5.prefab.dat
Assets/Resources/MapRes/4/Box_C6.prefab	assets/resources/mapres/4/box_c6.prefab.dat
Assets/Resources/MapRes/4/Box_C7.prefab	assets/resources/mapres/4/box_c7.prefab.dat
Assets/Resources/MapRes/4/Box_C8.prefab	assets/resources/mapres/4/box_c8.prefab.dat
Assets/Resources/MapRes/4/Box_D1.prefab	assets/resources/mapres/4/box_d1.prefab.dat
Assets/Z ! Voxel BlocksAssets/Prefabs/Materials/BoxD.mat	assets/z!voxelblocksassets/prefabs/materials/boxd.mat.dat
Assets/Z ! Voxel BlocksAssets/Prefabs/Textures/BoxD.psd	assets/z!voxelblocksassets/prefabs/textures/boxd.psd.dat
Assets/Resources/MapRes/4/Box_D2.prefab	assets/resources/mapres/4/box_d2.prefab.dat
Assets/Resources/MapRes/4/Box_D3.prefab	assets/resources/mapres/4/box_d3.prefab.dat
Assets/Resources/MapRes/4/Box_D4.prefab	assets/resources/mapres/4/box_d4.prefab.dat
Assets/Resources/MapRes/4/Box_D5.prefab	assets/resources/mapres/4/box_d5.prefab.dat
Assets/Resources/MapRes/4/Box_D6.prefab	assets/resources/mapres/4/box_d6.prefab.dat
Assets/Resources/MapRes/4/Box_D7.prefab	assets/resources/mapres/4/box_d7.prefab.dat
Assets/Resources/MapRes/4/Box_D8.prefab	assets/resources/mapres/4/box_d8.prefab.dat
Assets/Resources/MapRes/5/Box_M1.prefab	assets/resources/mapres/5/box_m1.prefab.dat
Assets/Z ! Voxel BlocksAssets/Prefabs/Models/Box_M1.FBX	assets/z!voxelblocksassets/prefabs/models/box_m1.fbx.dat
Assets/Z ! Voxel BlocksAssets/Prefabs/Materials/BoxM.mat	assets/z!voxelblocksassets/prefabs/materials/boxm.mat.dat
Assets/Z ! Voxel BlocksAssets/Prefabs/Textures/BoxM.psd	assets/z!voxelblocksassets/prefabs/textures/boxm.psd.dat
Assets/Resources/MapRes/5/Box_M2.prefab	assets/resources/mapres/5/box_m2.prefab.dat
Assets/Z ! Voxel BlocksAssets/Prefabs/Models/Box_M2.FBX	assets/z!voxelblocksassets/prefabs/models/box_m2.fbx.dat
Assets/Resources/MapRes/5/Box_M3.prefab	assets/resources/mapres/5/box_m3.prefab.dat
Assets/Z ! Voxel BlocksAssets/Prefabs/Models/Box_M3.FBX	assets/z!voxelblocksassets/prefabs/models/box_m3.fbx.dat
Assets/Resources/MapRes/5/Box_M4.prefab	assets/resources/mapres/5/box_m4.prefab.dat
Assets/Z ! Voxel BlocksAssets/Prefabs/Models/Box_M4.FBX	assets/z!voxelblocksassets/prefabs/models/box_m4.fbx.dat
Assets/Resources/MapRes/5/Box_M5.prefab	assets/resources/mapres/5/box_m5.prefab.dat
Assets/Z ! Voxel BlocksAssets/Prefabs/Models/Box_M5.FBX	assets/z!voxelblocksassets/prefabs/models/box_m5.fbx.dat
Assets/Resources/MapRes/5/Box_M6.prefab	assets/resources/mapres/5/box_m6.prefab.dat
Assets/Z ! Voxel BlocksAssets/Prefabs/Models/Box_M6.FBX	assets/z!voxelblocksassets/prefabs/models/box_m6.fbx.dat
Assets/Resources/MapRes/5/Box_M8.prefab	assets/resources/mapres/5/box_m8.prefab.dat
Assets/Resources/MapRes/5/Box_N1.prefab	assets/resources/mapres/5/box_n1.prefab.dat
Assets/Z ! Voxel BlocksAssets/Prefabs/Materials/BoxN.mat	assets/z!voxelblocksassets/prefabs/materials/boxn.mat.dat
Assets/Z ! Voxel BlocksAssets/Prefabs/Textures/BoxN.psd	assets/z!voxelblocksassets/prefabs/textures/boxn.psd.dat
Assets/Resources/MapRes/5/Box_N2.prefab	assets/resources/mapres/5/box_n2.prefab.dat
Assets/Resources/MapRes/5/Box_N3.prefab	assets/resources/mapres/5/box_n3.prefab.dat
Assets/Resources/MapRes/5/Box_N4.prefab	assets/resources/mapres/5/box_n4.prefab.dat
Assets/Resources/MapRes/5/Box_N5.prefab	assets/resources/mapres/5/box_n5.prefab.dat
Assets/Resources/MapRes/5/Box_N6.prefab	assets/resources/mapres/5/box_n6.prefab.dat
Assets/Resources/MapRes/6/Box_O1.prefab	assets/resources/mapres/6/box_o1.prefab.dat
Assets/Z ! Voxel BlocksAssets/Prefabs/Textures/BoxO.psd	assets/z!voxelblocksassets/prefabs/textures/boxo.psd.dat
Assets/Z ! Voxel BlocksAssets/Prefabs/Materials/BoxO.mat	assets/z!voxelblocksassets/prefabs/materials/boxo.mat.dat
Assets/Resources/MapRes/6/Box_O2.prefab	assets/resources/mapres/6/box_o2.prefab.dat
Assets/Resources/MapRes/6/Box_O3.prefab	assets/resources/mapres/6/box_o3.prefab.dat
Assets/Resources/MapRes/6/Box_O4.prefab	assets/resources/mapres/6/box_o4.prefab.dat
Assets/Resources/MapRes/7/Box_M7.prefab	assets/resources/mapres/7/box_m7.prefab.dat
Assets/Resources/MapRes/7/Box_O5.prefab	assets/resources/mapres/7/box_o5.prefab.dat
Assets/Resources/MapRes/7/Box_O6.prefab	assets/resources/mapres/7/box_o6.prefab.dat
Assets/Resources/MapRes/7/Box_O7.prefab	assets/resources/mapres/7/box_o7.prefab.dat
Assets/Resources/MapRes/7/Box_O8.prefab	assets/resources/mapres/7/box_o8.prefab.dat
Assets/Resources/MapRes/8/Box_Water_A.prefab	assets/resources/mapres/8/box_water_a.prefab.dat
Assets/Z ! Voxel BlocksAssets/Scripts/Scroll_UV.js	assets/z!voxelblocksassets/scripts/scroll_uv.js.dat
Assets/Z ! Voxel BlocksAssets/Prefabs/Textures/Box_Water_AB.psd	assets/z!voxelblocksassets/prefabs/textures/box_water_ab.psd.dat
Assets/Z ! Voxel BlocksAssets/Prefabs/Materials/Box_Water_AB.mat	assets/z!voxelblocksassets/prefabs/materials/box_water_ab.mat.dat
Assets/Resources/MapRes/8/Box_Water_B.prefab	assets/resources/mapres/8/box_water_b.prefab.dat
Assets/Resources/MapRes/9/Box_Water_C.prefab	assets/resources/mapres/9/box_water_c.prefab.dat
Assets/Resources/MapRes/9/Box_Water_D.prefab	assets/resources/mapres/9/box_water_d.prefab.dat
Assets/Resources/Table/Character.csv	assets/resources/table.dat
Assets/Resources/Table/Map.csv	assets/resources/table.dat
Assets/Scenes/Map.unity	assets/scenes/map.dat