Assets/Resources/AI	Assets/Resources/AI
Assets/Resources/Slua	Assets/Resources/Slua
Assets/Resources/Data	Assets/Resources/Data
Assets/Resources/Animation	Assets/Resources/Animation
Assets/Resources/Content/UI/ActivityWindow	Assets/Content/UI/ActivityWindow
Assets/Resources/Content/UI/Animation	Assets/Content/UI/Animation
Assets/Resources/Content/UI/BattlePrepare	Assets/Content/UI/BattlePrepare
Assets/Resources/Content/UI/BattleUI	Assets/Content/UI/BattleUI
Assets/Resources/Content/UI/BG	Assets/Content/UI/BG
Assets/Resources/Content/UI/CharacterShowWindow	Assets/Content/UI/CharacterShowWindow
Assets/Resources/Content/UI/ChatUI	Assets/Content/UI/ChatUI
Assets/Resources/Content/UI/Chip	Assets/Content/UI/Chip
Assets/Resources/Content/UI/Common	Assets/Content/UI/Common
Assets/Resources/Content/UI/DeathDetails	Assets/Content/UI/DeathDetails
Assets/Resources/Content/UI/EventSelectWindow	Assets/Content/UI/EventSelectWindow
Assets/Resources/Content/UI/FriendWindow	Assets/Content/UI/FriendWindow
Assets/Resources/Content/UI/GlobalTips	Assets/Content/UI/GlobalTips
Assets/Resources/Content/UI/Guide	Assets/Content/UI/Guide
Assets/Resources/Content/UI/GveResultWindow	Assets/Content/UI/GveResultWindow
Assets/Resources/Content/UI/HeroTrialWindow	Assets/Content/UI/HeroTrialWindow
Assets/Resources/Content/UI/InnerGrowth	Assets/Content/UI/InnerGrowth
Assets/Resources/Content/UI/Ladder	Assets/Content/UI/Ladder
Assets/Resources/Content/UI/Liveness	Assets/Content/UI/Liveness
Assets/Resources/Content/UI/LoadingWindow	Assets/Content/UI/LoadingWindow
Assets/Resources/Content/UI/Login	Assets/Content/UI/Login
Assets/Resources/Content/UI/Lottery	Assets/Content/UI/Lottery
Assets/Resources/Content/UI/MailWindow	Assets/Content/UI/MailWindow
Assets/Resources/Content/UI/Main	Assets/Content/UI/Main
Assets/Resources/Content/UI/Mall	Assets/Content/UI/Mall
Assets/Resources/Content/UI/Mix	Assets/Content/UI/Mix
Assets/Resources/Content/UI/PkMatchingTeam	Assets/Content/UI/PkMatchingTeam
Assets/Resources/Content/UI/PlayerData	Assets/Content/UI/PlayerData
Assets/Resources/Content/UI/PveBattleAccountWindow	Assets/Content/UI/PveBattleAccountWindow
Assets/Resources/Content/UI/PvpBattleAccount	Assets/Content/UI/PvpBattleAccount
Assets/Resources/Content/UI/PvpVsTeam	Assets/Content/UI/PvpVsTeam
Assets/Resources/Content/UI/PvpBattleAccount	Assets/Content/UI/PvpBattleAccount
Assets/Resources/Content/UI/RankList	Assets/Content/UI/RankList
Assets/Resources/Content/UI/Reborn	Assets/Content/UI/Reborn
Assets/Resources/Content/UI/Result	Assets/Content/UI/Result
Assets/Resources/Content/UI/RogueBattleResult	Assets/Content/UI/RogueBattleResult
Assets/Resources/Content/UI/SelectCharacter	Assets/Content/UI/SelectCharacter
Assets/Resources/Content/UI/Sprites	Assets/Content/UI/Sprites
Assets/Resources/Content/UI/SupplyBox	Assets/Content/UI/SupplyBox
Assets/Resources/Content/UI/TaskWindow	Assets/Content/UI/TaskWindow
Assets/Resources/Content/UI/TeamMatch	Assets/Content/UI/TeamMatch
Assets/Resources/Content/UI/TrainField	Assets/Content/UI/TrainField